10
10
3 3 3 3 2 0 0 3 3 3
4 1 1 3 0 0 0 3 1 4
1 5 1 3 0 0 0 3 8 1
1 1 1 3 0 0 0 3 1 1
1 1 1 3 0 0 0 3 1 5
1 1 1 3 0 0 0 3 1 1
1 1 1 1 1 1 1 1 1 1
1 1 1 1 1 8 1 1 1 1
1 1 1 1 1 1 1 1 1 1
1 1 1 5 1 4 1 6 1 1