10
10
3 2 0 0 3 3 3 3 3 3
3 0 0 0 3 3 3 3 3 3
3 0 0 0 3 1 1 1 7 1
3 0 0 0 3 1 1 8 1 1
3 0 0 0 3 1 4 1 1 1
3 0 0 0 3 1 1 1 1 1
1 1 8 1 1 1 1 1 1 1
1 1 6 1 1 6 1 6 1 1
1 1 1 4 1 1 4 1 4 1
5 1 1 1 5 1 1 1 5 1
